32 19 0 0
10 10 10 10 10 10 10 10 10 10 10 10 10 10 10 10 10 10 10 10 10 10 10 10 10 10 10 10 10 10 10 10
10 9 9 9 9 9 11 11 11 9 9 9 9 9 9 9 9 9 9 9 9 9 9 9 9 9 9 9 9 9 9 10
9 9 9 9 9 9 11 11 11 11 9 9 9 9 11 9 9 9 9 9 9 9 9 9 9 9 9 9 9 9 9 10
9 9 9 9 9 9 11 11 11 11 9 9 9 9 9 9 9 9 9 9 11 9 9 9 9 9 9 9 9 9 9 10
10 9 9 9 9 9 9 9 11 9 9 9 9 9 9 9 9 11 9 11 9 9 9 9 11 9 9 9 9 9 9 10
10 9 9 9 9 9 9 9 11 11 9 9 9 9 9 9 11 9 9 11 9 9 9 9 9 9 9 9 9 9 9 10
10 9 9 9 9 9 9 9 9 9 9 9 9 9 9 9 9 9 9 9 9 9 9 9 9 9 9 9 9 9 9 10
10 9 9 9 9 9 9 9 9 9 9 9 9 9 9 9 9 9 9 9 9 9 9 11 9 9 9 9 9 9 9 10
10 9 9 9 9 9 9 9 9 9 9 9 9 9 9 9 9 9 9 9 11 9 9 9 9 9 9 9 11 11 11 10
10 9 9 9 9 9 9 9 9 9 9 9 9 9 9 9 9 9 9 9 9 9 9 9 9 9 9 9 9 9 9 10
10 9 9 9 9 9 9 9 9 9 9 9 9 9 9 9 9 9 9 9 9 9 9 9 11 9 9 9 11 11 11 10
10 9 9 9 9 9 9 9 9 9 11 11 11 9 9 9 11 11 11 11 11 11 9 9 9 9 9 9 9 9 9 10
10 9 9 9 9 9 9 9 9 9 9 9 9 9 9 9 9 9 9 9 9 9 9 9 9 9 9 9 9 9 9 10
10 11 11 11 11 11 11 11 9 9 9 9 9 9 9 9 9 9 9 9 9 9 9 9 9 9 9 9 9 9 9 10
10 9 9 9 9 9 9 9 9 9 11 9 9 9 9 9 9 9 9 9 9 9 9 9 9 9 9 9 9 9 9 10
10 10 10 10 10 9 9 9 11 9 9 9 9 9 9 11 11 11 9 9 9 9 9 9 9 9 9 9 9 9 9 10
10 9 9 9 9 10 9 9 9 9 11 9 9 9 9 9 11 11 11 9 9 9 9 9 9 9 9 9 9 9 9 10
10 9 9 9 9 10 9 9 9 9 11 9 9 9 9 9 11 11 11 9 9 9 9 9 9 9 9 9 9 9 9 10
10 10 10 10 10 10 10 10 10 10 10 10 10 10 10 10 10 10 10 10 10 10 10 10 10 9 9 10 10 10 10 10