32 19 0 0
6 6 6 6 6 6 6 6 6 6 6 6 6 6 6 6 6 6 6 6 6 6 6 7 7 6 6 6 6 6 6 6
6 7 7 7 6 6 6 7 7 7 7 7 7 6 6 6 6 6 7 7 7 7 7 7 7 6 6 6 7 7 7 6
6 7 7 7 6 6 6 7 7 7 7 7 7 6 6 6 6 6 7 7 7 7 7 7 7 6 6 6 7 7 7 6
6 7 7 7 7 7 7 7 7 7 7 7 7 6 6 6 6 6 7 7 7 7 7 7 7 7 7 7 7 7 7 6
6 7 7 7 7 7 7 7 7 7 7 7 7 5 5 5 5 5 7 7 7 7 7 7 7 7 7 7 7 7 7 6
6 7 7 7 7 7 7 7 7 7 7 7 7 5 5 5 5 5 7 7 7 7 7 7 7 7 7 7 7 7 7 6
6 7 7 7 7 7 7 7 7 7 7 7 7 5 7 7 7 5 7 7 7 7 7 7 7 7 7 7 7 7 7 6
6 7 7 7 7 7 7 7 7 7 7 7 7 5 7 7 7 5 7 7 7 7 7 7 7 7 7 7 7 7 7 6
6 7 7 7 7 7 7 7 7 7 7 7 7 7 7 7 7 7 7 7 7 7 5 5 5 5 5 5 7 7 7 6
6 7 7 7 7 7 5 5 5 7 7 7 7 7 7 7 7 7 7 7 7 7 5 6 6 6 6 5 7 7 7 6
6 7 7 7 7 7 5 6 5 7 7 7 7 7 7 7 7 7 7 7 7 7 5 6 6 6 6 5 7 7 7 6
6 7 7 7 7 7 5 5 5 7 7 7 7 7 7 7 7 7 7 7 7 7 5 5 5 5 5 5 7 7 7 6
6 7 7 7 7 7 7 7 7 7 7 7 7 7 7 7 7 7 7 7 7 7 7 7 7 7 7 7 7 7 7 6
6 7 7 7 7 7 7 7 7 7 7 7 7 7 7 7 7 7 7 7 7 7 7 7 7 7 7 7 7 7 7 6
6 7 7 7 7 7 7 7 7 7 7 7 7 7 7 7 7 7 7 7 7 7 7 7 7 7 7 7 7 7 7 6
6 6 6 6 6 6 6 7 7 7 7 5 5 5 5 5 5 5 5 5 7 7 7 7 7 6 6 6 6 6 6 6
6 6 6 6 6 6 6 7 7 7 7 5 6 6 6 6 6 6 6 5 7 7 7 7 7 6 6 6 6 6 6 6
6 6 6 6 6 6 6 7 7 7 7 5 5 5 5 5 5 5 5 5 7 7 7 7 7 6 6 6 6 6 6 6
6 6 6 6 6 6 6 6 6 6 6 6 6 6 6 6 6 6 6 6 6 6 6 6 6 6 6 6 6 6 6 6